SVRO0000 , 3 , 3 , 3 , 3 , 3 , 3 , 3 , 3
SVRO1234 , 4 , 4 , 4 , 4 , 4 , 4 , 4 , 4
SVRO1235 , 4 , 4 , 4 , 4 , 4 , 4 , 4 , 4
SVRO1235 , 4 , 4 , 4 , 4 , 4 , 4 , 4 , 4
SVRO1235 , 4 , 4 , 4 , 4 , 4 , 4 , 4 , 4
SVRO1236 , 4 , 4 , 4 , 4 , 4 , 4 , 4 , 4
SVRO-1231,Vip,12333,123,12,Vip,qưe,qưe,123123123
